---M-----------------------------P-P-
--M-M-------------S-S-S-S--------P----
------M----------S-S-------------P----
-M-M-M-M-M----------S-S-S----------C--
------M-M-M-M-M----S-S-S-S---------B--
---------M-M-M------------S-S------U--
----------M-M-----------------------B-
-------O---M-M------O-O-O-O-O-O-O-O---
-------O----M-M-----O---O-O-O-O-O-O---
-------O------------O---O---O---O-----
-O-O-O-O-O-O-O------O-------O---O-----
-O-----------O------O-------O-O-O-----
-O---------P-O--O-O-O-------O-O-O-----
-O-----------O------O-E-O-O-O-O-O-O-O-
-O-B---------O------O-----------O---O-
-O-----------O------O-----------O---O-
-O-B------M--O------O-----------O---O-
-O-------M-M-O------O-O-O-O-O-O-O---O-
-O-B------M--O------O-----O-----O-O-O-
-O-----------O------O-----O-----O-----
-O-B---------O------O-----O-----O-----
-O-----------O------O-O-O-O-O-O-O-----
-O-----------O------O-------G---O-----
-O-----------O------O-----G-G---O-----
-O-O-O-O-O-O-O------O-----------O-----
-E--------------G-O-O-O-O-O-O-O-O-----
